##########
#Play  #
#        #
#  Exit  #
#        #
##########